barcode	enhancer	orientation
ATCCACCTAGACGCT	Cab-1	fwd
ATACAAAGACGAAAG	Cab-1	fwd
ATACCTGGCGACATG	Cab-1	fwd
ATAGCCCGTCAAACA	Cab-1	fwd
ATCACAGTGGTCAAA	Cab-1	fwd
ATACGTCGTGAGAAT	Cab-1	fwd
GATGGGGTTAAACTC	Cab-1	fwd
GCACATGCGAACACT	Cab-1	fwd
GGACTAACGGAGATT	Cab-1	fwd
AACGCCGCTGGTACA	Cab-1	fwd
CTGGGAATTACAGAA	Cab-1	rev
AAACTTCATACAGAC	Cab-1	rev
AATGGAACGGCGACG	Cab-1	rev
GGAACGACTGTTACA	Cab-1	rev
GTGAACAAAGGCAGA	Cab-1	rev
GTACATAACCCCATC	Cab-1	rev
GGACCCAGTGAAAAG	Cab-1	rev
CAAAACATCATTCTC	Cab-1	rev
ACAAGGATTACAGAC	Cab-1	rev
CGGAGTCCCAGAGAT	Cab-1	rev
AAACCACTAAGCACG	AB80	fwd
AACCAACAAAAGACT	AB80	fwd
AATCCTAAAGGCAGG	AB80	fwd
CCCCCGACTCATAGA	AB80	fwd
ACCAAAGGCCTTCAA	AB80	fwd
CTACCTACACGGATT	AB80	fwd
CCGGCTGGTACCCGA	AB80	fwd
ACTACGGCTGCAAAT	AB80	fwd
CCGAATAAACATATG	rbcS-E9	fwd
CGACAACTAGGTAAC	rbcS-E9	fwd
ACAAACAGAACTATG	rbcS-E9	fwd
CACCAAGTACTTCCT	rbcS-E9	fwd
GACCAACGAGGGGAA	rbcS-E9	fwd
CCTAGTCGTATGGAC	rbcS-E9	fwd
ACACAAATAGGACAT	rbcS-E9	fwd
ATGATAACTGATGTG	rbcS-E9	fwd
AAACAGCTTGCACGT	rbcS-E9	fwd
CAAGCTAACATAAGA	AB80	rev
AAAGCCACGGGCGCT	AB80	rev
AGTCACGCGGAAAAT	AB80	rev
CCTCCCAAGGAGCAC	AB80	rev
GTTCGACTACTAACA	AB80	rev
AGCGGTCGAGGTAGA	AB80	rev
CCTAGTACGCACACC	AB80	rev
ACCCCGCACCAAATA	AB80	rev
CGTGCGATTCAAATA	AB80	rev
GTAATCCAACTCCAC	AB80	rev
ACGCTAGCCACCCAA	rbcS-E9	rev
GTAATAAAGACTACT	rbcS-E9	rev
ATCACTATCGCAGAA	rbcS-E9	rev
ATAGAGGTTGATAAG	rbcS-E9	rev
AATACAGGAACCAAT	rbcS-E9	rev
CTGCCAAGTATTATA	rbcS-E9	rev
GGCATGGCAAACGAT	rbcS-E9	rev
ATCAGACTACAAGGA	rbcS-E9	rev
ATAGCCGCTAGGGGA	rbcS-E9	rev
