barcode	enhancer	orientation
CCCATCGCTGCCCTA	none	NA
AGCACGACCAAGGAG	none	NA
CCCGTCCTTCGCAGA	none	NA
GTAATAAGGGTCAAT	none	NA
CCGATAGTAACCAGC	none	NA
AACACGATAGGCACT	none	NA
AACGCAATAGACGAG	none	NA
CGCACTACCGGAGAC	none	NA
GAACAGATTAACAGC	none	NA
TACACGATAGGCACT	none	NA
GTCAACGACATGGGC	35S	fwd
ACTCACAGCAATACC	35S	fwd
ATAATAGGTGAAGCA	35S	fwd
ACCCTACAGAGGGTC	35S	fwd
AGAGTTATCCGTCAG	35S	fwd
AGAAGTCCCAACCTG	35S	fwd
CGAGTAGAACAACAC	35S	fwd
GCCGAAGTTCTACAG	35S	fwd
AGAAAAAAAGTACCG	35S	rev
CCACGACAAACAGTG	35S	rev
ATCGGACGGATAATT	35S	rev
GAAGATCAGAAACAA	35S	rev
AGGCAAGAGATCATT	35S	rev
AAAAATATCGAGCGG	35S	rev
CACCTAGGTGGGAAA	35S	rev
ACTACGGTGAAAATT	35S	rev
AAGGGAGTCCCGGAT	35S	rev
