barcode	enhancer
TGTTATTCCTCTTCC	none
TTCTGCTTCTTCTCC	none
TGTTACTACTACTCC	none
TTTTCCTCCTGCTCC	none
TTTTGTTGCTATTAC	none
TCCTACTACTATTCT	none
TATTTCTTTTATTGC	none
TTTTACTATTCTTCC	none
TACTATTACTATTGT	none
TATTCCTACTATTGC	none
TCCTATTGCTTCTGC	none
TATTTCTGTTATTGT	none
TACTGTTACTATTGT	none
TTCTTTTATTTTTAT	none
TCCTACTGCTTCTCT	none
TCCTTCTATTTTTTC	none
TTTTGTTGTTATTAC	none
TACTACTACTACTTC	none
TCTTGTTCCTCCTGC	none
TGTTGTTTTTACTCC	none
TGCTGTTATTTTTCT	35S
TATTCTTCCTATTTC	35S
TATTACTTTTTTTAC	35S
TTTTACTGCTTCTGT	35S
TATTATTATTATTTC	35S
TTCTATTGTTTTTAT	35S
TTCTCCTTCTACTTT	35S
TGCTATTATTGTTCC	35S
TCTTACTACTCCTCT	35S
TACTGCTTTTATTCC	35S
TACTACTCCTCCTGC	35S
TGCTGCTGTTGTTTT	35S
TCCTGTTACTATTGT	35S
TCCTATTTTTATTAC	35S
TATTCTTACTCTTTT	35S
TCTTGCTACTACTAT	35S
TTTTATTTCTCCTTT	35S
TACTATTTCTATTCT	35S
TCTTACTGCTCTTCC	35S
TTCTCTTCCTTCTTT	35S
